%%%%%%%%%%%%%%%%%%%%%%%%%%%%%%%
%%%.%.%.%.%...G..%..%.%...%.%%%
%%%.%.G.%.%....%....%.%...%.%%%
%.....%........P....%...%.....%
%.....%.%%%.%%%%%%%.%%%.%.%%%.%
%...%.%%%...%%% %%%...%%%.%...%
%...%.%%%%%.%%%%%%%.%.%%%.%...%
%.%%%.%.%%%.%%%%%%%.%%%.%.....%
%...%%%.%.%%%%.%.%%%%...%%%...%
%.......%......%......%.....%.%
%.....%.................%.....%
%.%...%.%......%......%.%.....%
%...%%%.%.%%%%.%.%%%%.%.%%%...%
%.%%%.......%     %.......%%%.%
%%%%%%%%%%%%%%%%%%%%%%%%%%%%%%%