%%%%%%%%%%%%%%%%%%%%%%%%%%%%%%%
%..............%......%.....%.%
%...%%%.%.%%%%.%.%%%%...%%%...%
%.%%%.%.%%%.%%%%%%%.%%%.%.....%
%.....%........P....%...%.....%
%.%%%.......%     %.......%%%.%
%%%.%.G.%.%....%....%.%.....%%%
%.....%.%%%.%%%%%%%.%%%.%.%%%.%
%...%.%%%%%.%%%%%%%.%.%%%.%...%
%...%.%%%.%.%%% %%%.%.%%%.%...%
%.....%.................%.....%
%...%%%.%.%%%%.%.%%%%.%.%%%...%
%.%...%.%......%......%.%.....%
%%%.%.%.%.%...G..%..%.%...%.%%%
%%%%%%%%%%%%%%%%%%%%%%%%%%%%%%%