%%%%%%%%%%%%%%%%%%%%%%%%%%%%%%%
%.%...%.%......%......%.%.....%
%.....%.%%%.%%%%%%%.%%%.%.%%%.%
%.....%........P....%...%.....%
%...%.%%%%%.%%%%%%%.%.%%%.%...%
%.....%.................%.....%
%.%%%.......%     %.......%%%.%
%...%%%.%.%%%%.%.%%%%.%.%%%...%
%...%%%.%.%%%%.%.%%%%...%%%...%
%%%.%.%.%.%...G..%..%.%...%.%%%
%%%.%.G.%.%....%....%.%...%.%%%
%...%.%%%.%.%%% %%%.%.%%%.%...%
%.......%......%......%.....%.%
%.%%%.%.%%%.%%%%%%%.%%%.%.....%
%%%%%%%%%%%%%%%%%%%%%%%%%%%%%%%