%%%%%%%%%%%%%%%%%%%%%%%%%%%%%%%
%...%%%.%.%%%%.%.%%%%.%.%%%...%
%.....%.................%.....%
%.......%......%......%.....%.%
%.....%........P....%...%.....%
%.%%%.......%     %.......%%%.%
%%%.%.%.%.%...G..%..%.%...%.%%%
%...%.%%%.%.%%% %%%.%.%%%.%...%
%%%.%.G.%.%....%....%.%...%.%%%
%.%...%.%......%......%.%.....%
%...%%%.%.%.%%.%.%%.%...%%%...%
%.....%.%%%.%%%%%%%.%%%.%.%%%.%
%.%%%.%.%%%.%%%%%%%.%%%.%.....%
%...%.%%%%%.%%%%%%%.%%%%%.%...%
%%%%%%%%%%%%%%%%%%%%%%%%%%%%%%%