%%%%%%%%%%%%%%%%%%%%%%%%%%%%%%%
%.....%.................%.....%
%.....%........P....%...%.....%
%.......%......%......%.....%.%
%.%...%.%......%......%.%.....%
%.....%.%%%.%%%%%%%.%%%.%.%%%.%
%...%.%%%%%.%%%%%%%.%.%%%.%...%
%.%%%.......%     %.......%%%.%
%.%%%.%.%%%.%%%%%%%.%%%.%.....%
%...%%%.%.%%%%.%.%%%%...%%%...%
%...%%%.%.%%%%.%.%%%%.%.%%%...%
%%%...%.%.%...G..%..%.....%.%%%
%%%.%.G........%......%...%.%%%
%...%.%%%.%.%%% %%%.%.%%%.%...%
%%%%%%%%%%%%%%%%%%%%%%%%%%%%%%%