%%%%%%%%%%%%%%%%%%%%%%%%%%%%%%%
%.....%........P....%...%.....%
%.......%......%......%.....%.%
%.%...%.%......%......%.%.....%
%...%.%%%%%.%%%%%%%.%.%%%.%...%
%.%%%.%.%%%.%%%%%%%.%%%.......%
%...%%%.%.%%%%.%.%%%%...%%%...%
%%%.......%...G..%....%...%.%%%
%%%.%.G.%.%....%....%.%...%.%%%
%...%%%.%.%%%%.%.%%%%.%.%%%...%
%...%.%%%.%.%%% %%%.%.%%%.%...%
%.....%.%%%.%%%%%%%.%%%.%.%%%.%
%.....%.................%.....%
%.%%%.......%     %.......%%%.%
%%%%%%%%%%%%%%%%%%%%%%%%%%%%%%%