%%%%%%%%%%%%%%%%%%%%%%%%%%%%%%%
%...%.%%%.%.%%% %%%.%.%%%.%...%
%.......%......%......%.....%.%
%.%%%.......%     %.......%%%.%
%.%%%.%.%%%.%%%%%%%.%%%.%.....%
%.....%.%%%.%%%%%%%.%%%.%.%%%.%
%...%%%.%.%%%%.%.%%%%...%%%...%
%%%.%.G.%.%....%....%.%...%.%%%
%%%.%.%.%.%...G..%..%.%...%.%%%
%.%...%.%......%......%.%.....%
%.....%........P....%...%.....%
%...%.%%%%%.%%%%%%%.%.%%%.%...%
%.....%.................%.....%
%...%%%.%.%%%%.%.%%%%.%.%%%...%
%%%%%%%%%%%%%%%%%%%%%%%%%%%%%%%