%%%%%%%%%%%%%%%%%%%%%%%%%%%%%%%
%.%%%.......%     %.......%%%.%
%.....%.................%.....%
%...%.%%%%%.%%.%.%%.%.%%%.%...%
%...%%%...%%%%.%.%%%%...%%%...%
%.%%%...%%%.%%%%%%%.%%%.%.....%
%...%.%%%.%.%%% %%%.%.%%%.%...%
%.......%......%......%.....%.%
%%%.%.%.%.%...G..%..%.%...%.%%%
%...%%%.%.%%%%.%.%%%%...%%%...%
%.....%........P....%...%.....%
%.....%.%%%.%%%%%%%.%%%.%.%%%.%
%.%...%.%......%......%.%.....%
%%%.%.G.%.%....%....%.%...%.%%%
%%%%%%%%%%%%%%%%%%%%%%%%%%%%%%%