%%%%%%%%%%%%%%%%%%%%%%%%%%%%%%%
%.............................%
%...%%%.%.%%%%.%.%%%%.%.%%%...%
%%%.%.G.%.%....%....%.%...%.%%%
%...%%%.%.%%%%.%.%%%%...%%%...%
%.%...%........%......%.%.....%
%...%.%%%%%.%%%%%%%.%.%%%.%...%
%.....%........P....%...%.....%
%...%.%%%.%.%%% %%%.%.%%%.%...%
%.%%%.%.%%%.%%%%%%%.%%%.%.....%
%.....%.%%%.%%%%%%%.%%%.%.%%%.%
%.......%......%......%.....%.%
%.%.%.......%     %.......%%%.%
%%%.%.%.%.%...G..%..%.%.....%%%
%%%%%%%%%%%%%%%%%%%%%%%%%%%%%%%