%%%%%%%%%%%%%%%%%%%%%%%%%%%%%%%
%...%%%...%%%%...%%%%...%%%...%
%...%.%%%.%.%%% %%%.%.%%%.%...%
%.....%........P....%...%.....%
%.%%%.......%     %.......%%%.%
%%%.%.%.%.%...G..%..%.%...%.%%%
%.%...%.%......%......%.%.....%
%.%%%.%.%%%.%%%%%%%.%%%.%.....%
%.....%.................%.....%
%...%.%%%%%.%%%%%%%.%.%%%.%...%
%%%.%.G.%......%....%.%...%.%%%
%.....%.%%%.%%%%%%%.%%%.%.%%%.%
%.......%......%......%.....%.%
%...%%%.%.%%%%.%.%%%%.%.%%%...%
%%%%%%%%%%%%%%%%%%%%%%%%%%%%%%%