%%%%%%%%%
%    G  %
%.  P   %
%%     %%
%       %
%   G  .%
%%%%%%%%%