%%%%%%%%%
%       %
%.  P   %
%%     %%
%       %
%   G  .%
%%%%%%%%%