%%%%%%%%%
%.......%
%...P...%
%......%%
%.......%
%...G...%
%%%%%%%%%