%%%%%%%%
%P     %
%      %
%G     %
%  .   %
%%%%%%%%