%%%%%%%%
%  G   %
%P G   %
%G     %
%  .   %
%%%%%%%%