%%%%%%%%
%      %
%P G   %
%G     %
%  .   %
%%%%%%%%