%%%%%
%  G%
%P G%
%   %
%  .%
%%%%%