%%%%%%%%
%P     %
%      %
%G G   %
%  .   %
%%%%%%%%