%%%%%%%%%%%%%%%%%%%%
%.   %        %   .%
%    % %%  %% %  % %
%       %  %     % %
% %        %% %% % %
%          G% %    %
% %    % % %% %  % %
% %    %. oo% %  % %
% %    %%%%%% %  % %
% %%%         %  % %
%    % %%%%%% %    %
%.   %   P    %   .%
%%%%%%%%%%%%%%%%%%%%
