%%%%%%%%%%%%%%%%%%%%
%.   %        %   .%
%    % %%  %% %  % %
%       %  %     % %
% %        %% %% % %
%         GG% %    %
% %    % %%%% %  % %
% %    %. oo% %  % %
% %    %%%%%% %  % %
% %%%         %  % %
%    % %%%%%% %    %
%.   %   P    %   .%
%%%%%%%%%%%%%%%%%%%%
